1,1,1,1,1,1,1,1,1,1,1,1,1,1,1,1,1,1,1,1,1,1,1,1,1,1,1,1,1,1,1,
1,2,2,2,2,3,2,2,2,2,2,2,2,3,3,15,2,2,17,2,2,2,2,13,2,2,2,2,2,2,1,
1,2,1,2,1,2,1,2,1,3,1,2,1,2,1,3,1,2,1,2,1,2,1,2,1,3,1,2,1,2,1,
1,2,2,2,2,2,2,2,3,14,2,3,2,2,2,2,2,3,2,2,2,2,2,3,2,2,2,3,2,2,1,
1,2,1,2,1,3,1,2,1,2,1,2,1,2,1,2,1,2,1,2,1,2,1,2,1,2,1,2,1,2,1,
1,3,2,2,2,3,2,2,2,2,3,2,2,13,2,2,2,3,2,2,3,3,3,2,3,2,2,2,3,3,1,
1,2,1,2,1,3,1,2,1,2,1,3,1,3,1,2,1,3,1,2,1,3,1,2,1,2,1,2,1,2,1,
1,2,2,2,3,2,2,2,2,2,2,2,3,3,2,3,2,2,3,2,2,2,2,2,2,2,2,16,2,2,1,
1,2,1,2,1,2,1,2,1,2,1,2,1,2,1,2,1,2,1,2,1,2,1,2,1,3,1,2,1,2,1,
1,2,2,3,2,2,2,17,3,2,2,2,3,2,2,2,3,16,3,2,3,2,2,3,2,3,2,2,2,2,1,
1,3,1,2,1,2,1,3,1,2,1,2,1,3,1,2,1,2,1,3,1,3,1,2,1,2,1,2,1,15,1,
1,2,2,3,14,2,2,2,3,3,2,2,3,2,2,3,2,9,2,3,2,2,17,2,13,2,2,2,3,3,1,
1,1,1,1,1,1,1,1,1,1,1,1,1,1,1,1,1,1,1,1,1,1,1,1,1,1,1,1,1,1,1
4 5 5